################
#.#G.#.#G.#.#G.#
#.#..#.#..#.#..#
#.#..#.#..#.#..#
#.#..#.#..#.#..#
#.#..#.#..#.#..#
# .... .... ...#
#..............X
#..............X
#... .... .... #
#..#.#..#.#..#.#
#..#.#..#.#..#.#
#..#.#..#.#..#.#
#..#.#..#.#..#.#
#.G#.#.G#.#.G#.#
################