################
#..............#
#..............#
#..##########..#
#...........#..#
#...........#..#
##########..#..#
X..#...GG#..#..#
X..#...GG#..#..#
#..#..####..#..#
#..#........#..#
#..#........#..#
#..##########..#
#..............#
#..............#
################