################
#..............#
#......GG......#
#..##########..#
#...........#..#
#...........#..#
##########..#..#
X..#.....#..#..#
X..#...GG#..#..#
#..#..####..#..#
#..#...........#
#..#...........#
#..#######..W..#
#..............#
#..............#
################