#######XX#######
#..............#
#..............#
#    ..........#
#....... ... ..#
#...G... ... ..#
#...... .... ..#
#..... ..G.. ..#
#.... ..... ...#
#... ..... ....#
#.. ..G.. ..H..#
#... ..... ....#
#.... ..... ...#
#..G.. ..G.. ..#
#...... ..... .#
################