################
#.............##
#....GGGGG...#.#
# ....GGG...#..#
#. ....G...#...#
#.. ......#....#
#... ....#...G.#
X.... ..#...GG.#
X..........GGG.#
#...........GG.#
#....... ....G.#
#.G...... .....#
#.GG...... ....#
#.GGG...... ...#
#........... ..#
#######XX#######