################
#..............#
#..  ..  ..  ..#
#..  ..  ..  ..#
#..............#
#....GG..GG....#
#..............#
X....  ..  ....X
X....  ..  ....X
#..............#
#....GG..GG....#
#..............#
#..  ..  ..  ..#
#..  ..  ..  ..#
#..............#
################