################
#..............#
#..  ..  ..  ..#
#..  ..  ..  ..#
#..............#
#....GG..GG....#
#..............#
X...##....##...X
X...##.4..##...X
#..............#
#....GG..GG....#
#..............#
#..  ..  ..  ..#
#..  ..  ..  ..#
#..............#
################