#######XX#######
#..............#
#..............#
#..##########..#
#..#........#..#
#..#........#..#
#..#..#..#..#..#
#..#..#..#..#..X
#..#..#..#..#..X
#..#..#..#..#..#
#..#..#..#..#..#
#..#GG#..#GG#..#
#..####..####..#
#..............#
#..............#
################