#######XX#######
#..............#
#.G..........G.#
#......#.......#
#.....#.#......#
#....#...#.....#
#...#.G...#....#
X..#...G.G.#...#
X...#.......#..#
#....#.G.......#
#.....#........#
#......#.......#
#.......#......#
#.G........6...#
#..............#
################