#######XX#######
#..............#
#.G..........G.#
#......#.......#
#.....#.#......#
#....#...#.....#
#...#.G...#....#
X..#...G.G.#...#
X...#.......#..#
#....#.G.......#
#.....#........#
#......#.......#
#.......#...W..#
#.G............#
#..............#
################