#######XX#######
#..............#
#.G..........G.#
#......#.......#
#.....#.#......#
#....#...#.....#
#...#.G...#....#
X..#.....G.#...#
X...#.......#..#
#....#.G.......#
#.....#........#
#......#.......#
#.......#......#
#.G..........G.#
#..............#
################