#######XX#######
#..............#
#.  ........  .#
#.  ........  .#
#....G.  .G....#
#....G.  .G....#
#..............#
#.  ........  .#
#.  ........  .#
#..............#
#....G.  .G....#
#....G.  .G....#
#.  ........  .#
#.  ........  .#
#..............#
#######XX#######