#######XX#######
#..............#
#.  ........  .#
#.  ........  .#
#....G.##.G....#
#....G.##.G....#
#..............#
#.  ........  .#
#.  ...4....  .#
#..............#
#....G.##.G....#
#....G.##.G....#
#.  ........  .#
#.  ........  .#
#..............#
#######XX#######