################
#..............#
#.G..G..G..G...#
#............G.#
#.G.########...#
#...#      #...#
#...# #### #.G.#
#.G.# #  # #...X
#...# #  # #...X
#...# #### #.G.#
#.G.#      #...#
#...############
#..........#   #
#.G..G..G..# ###
#..........# # #
#######XX#######