################
#.....G..G.....#
#..............#
#......##......#
#..............#
#.6.........6..#
#..............#
X......##......X
X......##......X
#...#......#...#
#...#......#...#
#...###..###...#
#..............#
#.G..........G.#
#..............#
#######XX#######