################
#..............#
#.G....  ....G.#
#......  ......#
#......  ......#
#......  ......#
#......  ......#
X......  ......X
X......  ......X
#...#......#...#
#...#......#...#
#...###..###...#
#..............#
#.G..........G.#
#..............#
#######XX#######