#######XX#######
#.....#........#
#.G..#......GG.#
#........##.GG.#
#.........##...#
#.#........##..#
##..........##.#
X............###
X......W.....###
##..........##.#
#.#........##..#
#.........##...#
#........##.GG.#
#.G..#......GG.#
#.....#........#
#######XX#######