#######XX#######
#..............#
#G.............#
############...#
#..............#
#..............#
#...############
#..............X
#..............X
#...############
#..............#
#..............#
############...#
#G.............#
#..............#
#######XX#######