#######XX#######
##............##
#.#..........#.#
#..####..####..#
#..#G......G#..#
#..#........#..#
#..#........#..#
X..............X
X......W.......X
#..#........#..#
#..#........#..#
#..#G......G#..#
#..####..####..#
#.#..........#.#
##............##
#######XX#######