################
#..............#
#..............#
#..............#
#..............#
#..............#
#..............#
X..............#
X..............#
#..............#
#..............#
#..............#
#..............#
#..............#
#..............#
################